
same - algumas
only - somente
snore - roncar
make - fazer
borrow - emprestar 
crackers -bolacha
dissert - sobremesa
Busy (bise)= Ocupado
Lots = bastante
in fact = de fato 
classmate = colega de classe
mistakes = erros
worrys = preoculpa
pillows = travesseiro
Windshild - Parabrisa 
couch ("calt") = Sofá
cute (kilt) - Fofo(a)
bottles (boros) - potes
libriry - Biblioteca
chewing - mastigar
behavior - comportamento
indiferent - indiferente
mat - "met" - tapetes pequenos
sink = pia
counter = balcão
tap = torneira
vase = Vaso
blanket = lençol
mall = shopping
shop = loja
buy = compra
store = loja
backyard = Jardins dos Fundos
Deadline = Prazo final
drank - bebe (passado)

- Um só significado
    There was (der uos) = foi
    There were (der our) = estavam

- Posições e locais de Objetos
    in front of = em frente de
    Behind = atrás
    On - Em cima
    Under - Em baixo
    Above - Acima 
    Below - Abaixo
    Between - Entre
    Next to - Ao lado
    Near - Proximo


15 de Agosto de 2020
-instead: ao inves de
-hear: escutar
-judge: Juiz de Lei
-referee: juiz de esporte
-throat: garganta
-shove: enfiar/empurrar 
-push: empurrar
-pull: puxar
-him: 
-grades: notas
-improving: 

28 de Agosto de 2020
-saved: guardar (usado para coisas digitais)
-storaged: arquivar (usado para coisas fisicas)
-Their: 
-Bought: comprei (verb buy - Simple past)
-Often: Frequentemente
-regards: saudações
-chonky: 


Smart
Follow
Watch
Learn
scary
curse
